--------------------------------------------------------------------------------------------------------------------------------------------------------------------------------------------------------
--------------------------------------------------------------------------------------------------------------------------------------------------------------------------------------------------------
--------------------------------------------------------------------------------------------------------------------------------------------------------------------------------------------------------
--------------------------------------------------------------------------------------------------------------------------------------------------------------------------------------------------------
--------------------------------------------------------------------------------------------------------------------------------------------------------------------------------------------------------
--------------------------------------------------------------------------------------------------------------------------------------------------------------------------------------------------------
--------------------------------------------------------------------------------------------------------------------------------------------------------------------------------------------------------
-------------------------------------------------------------------------------------------------------------------------------------------------------------------------------------------------------v
-------------------------------------------------------------------------------------------------------------------------------------------------------------------------------------------------------f
-------------------------------------------------------------------------------------------------------------------------------------------------------------------------------------------------------f
--------------------------------------------------B----------------------------------------------------------------------------------------------------------------------------------------------------f
----------------------------X------------X-----X---------------X-------BBBBB---X------------------------T-------------------------BBBBB-------------------------------------------------------X--------f
---------------------------XX-----------XX----XX--------------XX---------------X------------------------|-----------BBB-B--------------------C---T---------T----------BBBB-------------------XX--------f
----------T---------------XXX-----------XX---XXX-------------XXX---------------X------------------------|----------------------------------------|---------|---------------------------------XX--------f
m---------|-E------------XXXX-----------XX--XXXX--------C---XXXX---------------X-----------------------E|-------------C---C----------------------|---------|--------------------------E------XX--------X
XXXXXXXXXX|XXXXXXXXXXXXXXXXXXXXXXXXXXXXXXXXXXXXXXXXXX-XXXXXXXXXXXXXXXXXXXXXXXXXXXXXXXXXXXXXXXXXXXXXXXXXX|-XXXXXXXXXXXXXXXXXXXXXXXXXXXXXXXXXXXXXXX|XXXXXXXXX|XXXXXXXXXXXXXXXXXXXXXXXXXXXXXXXXXXXXXXXXXXXX
