--------------------------------------------------------------------------------------------------------------------------------------------------------------------------------------------------------
--------------------------------------------------------------------------------------------------------------------------------------------------------------------------------------------------------
--------------------------------------------------------------------------------------------------------------------------------------------------------------------------------------------------------
--------------------------------------------------------------------------------------------------------------------------------------------------------------------------------------------------------
--------------------------------------------------------------------------------------------------------------------------------------------------------------------------------------------------------
--------------------------------------------------------------------------------------------------------------------------------------------------------------------------------------------------------
--------------------------------------------------------------------------------------------------------------------------------------------------------------------------------------------------------
-------------------------------------------------------------------------------------------------------------------------------------------------------------------------------------------------------v
-------------------------------------------------------------------------------------------------------------------------------------------------------------------------------------------------------f
-------------------------------------------------------------------------------------------------------------------------------------------------------------------------------------------------------f
------------------------------------------------------------BBBMB--------------------------------------------------------------------------------------------------------------------------------------f
------------X---------------X------------X-------------------X---------------------B-------------------------------------T-----------------------------------X-------------X---------------------------f
-----------XX--------------XX------------X------------------XX---------------------------------------T-------------------|-------------BBBBB----------------XX------------XX------T--------------------f
----------XXX--------------XX------------X-----------------XXX---------------------------------------|--------o----------|---------------------------------XXX------------XX------|--------------------f
m--------XXXX--------------XX------------X----------------XXXX-------E-------------------------------|-------------E-----|--------------------------------XXXX------------XX------|--------------------X
XXXXXXXXXXXXXXXXXXXXXXXXXXXXXXXXXXXXXXXXXXXXXXXXXXXXXXXXXXXXXXXXXXXXXXXXXXXXXXXXXXXXXXXXXXXXXXXXXXXXX|XXXXXXXXXXXXXXXXXX-|XXXXXXXXXXXXXXXXXXXXXXXXXXXXX-XXXXXXXXXXXXXX-XXXXXXXXXXX|XXXXXXXXXXXXXXXXXXXXX
