o------------------------------------------------------------------------------------------------------------------------------------------------------------------------------------------------------E
|------------------------------------------------------------------------------------------------------------------------------------------------------------------------------------------------------o
T-------------------------------------------------------------------------------------------------------------------------------------------------------------------------------------------------------
M------------------------------------------------------------------------------------------------------------------------------------------------------------------------------------------------------|
M------------------------------------------------------------------------------------------------------------------------------------------------------------------------------------------------------T
T----------o-oBX?oX---MB-EBB----------------------------------------------------------------------------------------------------oBXXXB--------oXXEEEE?----MEo???oo-E-XE?XMX??-o-EBMXEo--XXX-oBBE??E?---X
E---------MBBEMEMXXX-M--??EoEM-XEo------------------------------------------------------------------------------------------------------------------MMMooooo-XE-EEB---X?MEBo-B???XE-X?XEoEooMMX?X------?
T---------XXXo-BB?--EMXM?E-X-XM-MXX??-o---------------------------------------------------------------------------M-XBMoXX-?--MBBE---E--o-EXM-M--------------------------------------oEMMX-EEB-E?XoM---v
X---------BoMMEE?o--B---X?XBB?M-B?EXXX-XXXM-B?--BB?oEEE-----------------------------------------------------------------------------------------------------------------------------------------oX-B---|
B---------oX-----------------------------------------------------------------------------------------------------------------------------------------------------------??E-MMEXEB-oo?MX-oM?XBoBooooE---o
?BBBBB----BBBBBBBBBBBBBB??XE?XXX-XoB-oB---E-XM?XMB??--?XoEXEoX?E?-XoBXX-------------------------------------------------------------------------M-X--ME--XMEMX-EB?EX-Eoooo-E-?Bo??oMMXE-BoEMM-XXM-X----E
M--T--------o--?EXEEo-XXo-XBXE-MBo-o--B??EBMMBMoo--X-o-?-XMMMM-E-BXB-------------------------------------------------E-EEE------BEE--------------------------------------------------------------------T
M--|------------------MEoM-X-------------------------------------------------------------------------------------------------------------------------------------------XEE?MM-MBBB----oMMoXXo-oooXXM---?
X--|-------M---oBMM-oX-X???MBoB?o--EB-EE-?o--BBB?--MM---XMoo-BooEEXMXo--?Eoooo-o---o-?--o?o?ME-?X-------------------------------------------------------------------------------------------------oB---?
m--|--------?o-BEo--X?---BX--XX-o-T?-E?M-ETXEoT-o-MMTT--BT?XM-XTBXEXBXB?-T?ooT-EEXEMBXEMB-??X-EET--T-TBXXE-XT-ooT--B?E?T-EMoE-M-oX-------------------------------------------MXEEBTTM--B?BT-XXTBo?-X---E
XX-|--------XX-XXXX-XXXXXXXXXXXXXXXXXXXXXXXXXXXXXXXXXXXXXXXXXXXXXXXXXXXXXXXXXXXXXXXXXXXXXXXXXXXXXXXXXXXXXXXXXXXXXXXXXXXXXXXXXXXXXXXXXXXXXXXXXXXXXXXXXXXXXXXXXXXXXXXXXXXXXXXXXXXXXXXXXXXXXXXXXXXXXXXXXXXX
